##################
#           *    #
#          @     #
#            J   #
#        r       #
#                #
##################